TILEMAP
20 20							-- Size of tile map in tiles Mapsize.x Mapsize.y
16 							-- Tile size. Tamaño modelo es 16x16x16
11111111111111111111
1                  1
1                  1
1                  1
1   1 1 1 1 1  s   1
1                  1
1                  1
1                  1
1                  1
1                  1
1                  1
1                  1
1                  1
1                  1
1                  1
1                  1
1                  1
1                  1
1                  1
11111111111111111111