TILEMAP
60 20							-- Size of tile map in tiles Mapsize.x Mapsize.y
16 							-- Tile size. Tamaño modelo es 16x16x16
111111111111111111111111111111111111111111111111111111111111
1                  11                  11                  1
1                  11                  11                  1
1                  11                  11                  1
1                  11                  11                  1
1    1          s  11                  11                  1
1                  11             m    11                  1
1                  11                  11                  1
1                                                          1
1                                                          1
1                                                          1
1                  11                  11                  1
1                  11                  11                  1
1                  11                  11                  1
1                  11                  11                  1
1                  11       m          11                  1
1                  11                  11                  1
1    ppppp         11                  11                  1
1                  11                  11                  1
111111111111111111111111111111111111111111111111111111111111
