TILEMAP
60 20							-- Size of tile map in tiles Mapsize.x Mapsize.y
16 							-- Tile size. Tamaño modelo es 16x16x16
          11111111111111111111111111111111111111111111111111
          1                           p1                   1
          1                           p1          s        1
          1                           p1                   1
          1                           p1                   1
          1        111111111111        1                   1
          1        1p                  1                   1
          1        1p                  1                   1
          1        1p                  1                   1
          1        1p                  1                   1
          1        1p                  1                   1
          1        1          ppppppppp1                   1
          1        1          1111111111                   1
11111111111        1                  p1                   1
1                  1                                       1
1                  1                                       1
1                  1                                       1
1                  1                                       1
1                  1                  p1                   1
111111111111111111111111111111111111111111111111111111111111
