TILEMAP
60 20							-- Size of tile map in tiles Mapsize.x Mapsize.y
16 							-- Tile size. Tamaño modelo es 16x16x16
111111111111111111111111111111111111111111111111111111111111
1p                                     a                   1
1p                                     a               s   1
1p                                     a                   1
1p                 1                   111111111111111111111
1p                 1                   1                    
1                  1             aaaaaa1                    
1                  1             b     1                    
1         1111111111             b     1                    
1                 p1             b     1                    
1                 p1             b     1                    
1p                p1             b     1                    
1p                 1             b     1                    
1p                 1aaaaaaaaaaaaaa     1                    
11111111111        1                   1                    
1                  1                   1                    
1                 p1                   1                    
1                 p1                   1                    
1                 p1  i                1                    
1111111111111111111111111111111111111111                    