TILEMAP
60 20							-- Size of tile map in tiles Mapsize.x Mapsize.y
16 							-- Tile size. Tamaño modelo es 16x16x16
111111111111111111111111111111111111111111111111111111111111
1p                p1       1           l                   1
1p        k       p1    k  1           l                   1
1                  1       1           l                   1
1         1        1                   c                   1
1         1p       1                   c               s   1
1p        1p       1                   c                   1
1p        1        1           11111111111111111111111111111
1         1        1                   1                    
1         1       p1                   1                    
1        p1       p1                   1                    
1        p1        1      ppppppppp    1                    
1         1        1                   1                    
1         1p       1                   1                    
1p        1p       1                   1                    
1p        1        111111111111        1                    
1         1                            1                    
1         1                  k         1                    
1         1                            1                    
1111111111111111111111111111111111111111                    